NO ./texture/wall_n.xpm
SO ./texture/wall_s.xpm
EA ./texture/wall_e.xpm
WE ./texture/wall_w.xpm

F 0,0,0
C 255,255,255

11111111
10000001
100NN001
11000001
11111111